1111111111111111111111111111111111
1E00000000V0000C00000C00000V000001
1010010100100000101001000000010101
1010V100101010100V1001000000010101
1P0000000C00C000000000000V000000C1
1111111111111111111111111111111111
