1111111111111111111111111
11100jk0010000000000001C1
1100000CC00100000000C0001
10000EPC000C1010100000001
1111111111111111111111111
