1111111111
1C00000001
1000000001
1000000P01
1111111111
