1111111111
1P000000C1
1111111111
1000000E01
1111111111
