1111111111
1C00000001
1P10000001
100E000E01
1111111111
