1111111111
1C00000001
100000000000000001
1000000E01
1111111111
