11111111111111111111
1P010000111100000C11
10C0011011V0011E0011
11110V1000000C111C11
1C0001C011V0100C10V1
11111111111111111111
